1111111111
1000000001
1000000001
1000011101
1001000101
1001000101
1001111101
1000000001
1000000001
1111111111
