1111111111
1E00000001
1000000001
1000011101
1001000101
1001000101
1001111101
1000000001
10000000S1
1111111111
