1111111111111111111111111111111111
1S100000000000000000000000000000E1
1011110000100000101001000000010101
1011110010101010001001000000010101
1000000000000000000000000000000001
1111111111111111111111111111111111
