1111111111111111111111111111111111
10100000000000000000000000000001E1
1011110000100011111111000000010101
1011110010101010001101111111110001
1000000000000000000000000000111111
1111111111111111111111111110000001
100S000000000000000000000000000001
1111111111111111111111111111111111
