11111111111
10000000001
10111111101
10000000001
10111111111
10000000001
10111101101
10000000101
10000000001
10000000001
10000000001
11111111111
