11111111111
1S000000001
11111111101
10000000001
10111111001
10000000001
10111111111
10000000001
10010001001
10011111001
100000000E1
11111111111
