1111111111111111111111111111111111111111111111111
10000000001000000000010000000000000000010000000E1
1S00100010100011000001111111111100111111011111111
1000000010000011000011000000000000110011000000001
1111111111111111110111011111111110111111111110101
1000000000000000000000000000000010000000000000001
1111111111111111111111111111111111111111111111111
