11111111111
1S000000001
10111111101
10000000001
10111111111
10000000001
10111111101
10000000101
11111100111
10000000001
1E000000001
11111111111
